############
#          #
#          #
#    PO    #
#          #
#        X #
#    X     #
#       O  #
#          #
############
